WWWWWWWWWWWWWWWW
WFFFFFFFFFFFFFFW
WFFFFFFFFFFFFFFW
WFFFFFFFFFFFFFFW
WFFFFFFFFFFFFFFW
WFFFFFFFFFFFFFFW
WFFFFFFFFFFFFFFW
WFFFFFFFFFFFFFFW
WFFFFFFFFFFFFFFW
WFFFFFFFFFFFFFFW
WFFFFFFFFFFFFFFW
WFFFFFFFFFFFFFFW
WFFFFFFFFFFFFFFW
WFFFFFFFFFFFFFFW
WFFFFFFFFFFFFFFW
WWWWWWWWWWWWWWWW 